1111111111111111111111111111111111111111111111111
10P0000000000000000000000000000000000000000000001
11C0000000000000CC00000000000CCC00000000000000001
101C00000000000C11C000000000C111C0000000000000001
1001C000000000C1E01C0000000C10001C000000000000001
10001C0000000C10C001C00000C1000001C00000000000001
100001C00000C100C0001C000C100000001C0000000000001
1000001C000C1000C00001C0C10000000001C000000000001
10000001CCC10000C000001C1000000000001C00000000001
1000000011100000C000000100000000000001C0000000001
1000000000000000C000000000C0000000000C00000000001
1111111111111111111111111111111111111111111111111