1111111111111111111111111111111111111111111111111
10C0010CC1C0C0C0100C0C0000100C0010C00C000C0C000E1
100C0100010010C010C111111010C10C1C00C00111110C0C1
1C10C1C1C1C0100C10C1C0C0101C01C0100C00010C0100C01
1C10C101C10010C00C00C00C1010C10C11111111C0C10C001
1P1000C000CC00C00C0C000C0000CCCC000C0C00C00C00001
1111111111111111111111111111111111111111111111111